5
6
WWWWW
WFFFW
WPCFW
WWFFW
WTFFW
WWWWW
