6
6
WWWWWW
WFPWWW
WFCWTW
WFFFFW
WWFFFW
WWWWWW