7
5
WWWWWWW
WFPWWTW
WFCFFFW
WWFWFFW
WWWWWWW

